Position	ReportsTo
CFC	PARC Chief
COS	STGL
DAS	DIUL
DIUL	PARC Chief
DIUS	DIUL
DPAGS	PAGS
EHPR	CFC
EHPS	EHPR
EXDVS	EXGL
EXGL	PARC Chief
IM	PARC Chief
INSP	CFC
MTR	CFC
MTSP	CFC
ODIU	OPSL
OPSL	DPAGS
PARC Chief	DPAGS
PDM	PDTFL
PDTFL	DPAGS
QAS	CFC
SC	PARC Chief
SI	SITFL
SITFL	DPAGS
SMGR	OPSL
SPGL	PARC Chief
SPM	SPGL
SPND	OPSL
STDVS	STGL
STGL	PARC Chief
STPAS	STGL
TS	SPGL
